R 1080 720

NO ./textures/tex3.xpm
SO ./textures/tex2.xpm
WE ./textures/tex1.xpm
EA ./textures/tex4.xpm
S ./textures/kitty.xpm

F 111,55,0
C 200,222,200

 11111111111111111111111111111111
 100000010000000000000000000000011111111
 111111110000000001100000020000000000001
        10110000011100002000200011111111
        1001000000000000002000001
111111111011000001110000000000001
100000000011000001111111110111101
1111011111110101110111001000101011111111111
1111011111110101110111001000101000000000001
1100000011010101110111201000101000002000001
1000200020002000110111001020101000020200001
1000002000200000000101001000101000002000001
11000001110101011111011110N0101000020200001
1111011000110101010111101000111000002000001
1111111111111111111111111111111111111111111



