R 1444 1200

NO ./textures/tex3.xpm
SO ./textures/tex2.xpm
WE ./textures/tex1.xpm
EA ./textures/tex4.xpm
S ./textures/cats.xpm

F 12,128,8

C 12,8,228



111111111111111111111111111111111
12000000100001 100000000000000001
1000N000100001 100000000000000001
10000000100001 100000000000000001
10000000100001 100000000000000001
111111111011011101111100000000001
10000000001100000111 111110111101
11110111111101011101 10010001 1011111111111
11110111111101011101 10010001 1000000000001
11000000110101011101 12010001 1000002000001
10002000200020001101110010201 1000020200001
10000020002000000001010010001 1000002000001
11000001110101011111011110001 1000020200001
1111011000110101 10111101000111000002000001
1111111111111111 11111111111111111111111111




